0000000000000
00000000X0000
0000000010000
00X1000011X00
1001X00O11100
10O100011110e
1111101111110
