000000000000000000000000
000000000010000000000000
00000000101A000000000000
0000000B1A1A001000000000
000000001B10001000000000
000000001A1A001000000000
000000001010001000000000
000100001010001000000000
0001000010100A1000100000
00010000101A001000100000
0001000B1B1B001000101000
000100001B1000100010100e
000100AB1B1A101000101010
0001BA1A10101010101B1010
