1111111111111111
1s00110001000001
1110100011011101
1000001010011101
1000001010110001
1111101010100001
1000001010100011
1111111010111001
1000001010100011
1000001010111001
100010000010000e
1111111111111111
