000000000e
0000X000A1
000A100001
00001A00A1
000X100001
00111000A1
0111100001
01111X0001
0111100001
1111111111
