000000000000
000000000000
000100000000
000100001N0e
000100001010
000100MM1M1N
000100101010
